#################
#################
##             ##
##  V   #   W  ##
##      #      ##
##  9 W #   9  ##
##             ##
## @  #####  @ ##
##             ##
##  9   # W 9  ##
##      #      ##
##  W   #   V  ##
##             ##
#################
#################